1111111111111
1EC100CC000C1
1M00011111MC1
1PC011MM1C001
1111111111111
