1111111
110C001
101E101
1010101
110P001
1001101
1111111