1111111111111
1EC100CC000C1
10000111110C1
1PC011001C001
1111111111111
