1111111111111
1000000000001
1100010111001
1000110000001
1111111111111
