1111111111111
10010000000C1
110001011100
1PC011E0C0001
1111111111111