1111111111111
10E0000000001
1100010111001
100P1101C1001
1111111111111
