1111111111111
10C0000000001
1100010111001
100P1101E1001
1111111111111
