1111111111111
10C0000000001
1100010111001
100E1101P1001
1111111111111
