111111111111111111111111111111111111
1000000000000C000000C000000000000001
100001010101010101010101010101010001
101010100000000000000000001010101001
100000101111111111111111101000C01001
101010100000000000000000101010101001
101010111111111111111111101010101001
100000000000000000000000000000000E01
101111111111111111111111111111110001
100000000C000000C000000C000000000001
101111111111111111101111111111111101
100000000000000000000000000000000001
101011111111111111111111111111111001
101010000000000000C00000000000001001
101010101111111111111111111111101001
1000000010000000000000000000000000C1
101111101011111111111111111111101001
101000101000000000000000000000101001
101010101011111111111111111111101001
1P0000000000000000000000000000000001
111111111111111111111111111111111111
