1111111111111
10010000000C1
1000010111001
1P001100CE001
1111111111111
